11111111111
10000000001
10000000001
101P00010C1
10000000101
10010010001
11011001001
100C0000CE1
10C10000011
11111111111