111111111111111
10P00000C100011
101CC0000001001
10001000C000001
1000C0C00101001
110000C0EC01001
1000000000C0001
1000000C0000001
100000000000001
100000000000011
10000CC0C000001
111111111111111