111111111111111
10000C001C00011
1000C0000000001
100000000000001
100000000000001
10C000000000001
1000000000E0001
1C00000000C00C1
100000000010001
1000C0100000011
100000000C00001
10010C000C00001
100100000CP0001
1000000000C0101
111111111111111