11111111111
110000P0001
100CC00CE01
1CC00011CC1
100C0001001
11111111111