11111111111
10C001C0001
111000P0001
1000C001001
1E000000101
111C01110C1
100C0000001
110C0000001
1C00CC00101
1010C00C101
10100000C01
1100C000C01
10C100C1CC1
11111111111