11111111111
1C010C00001
10001000001
10000100001
101C000C001
100C0000C01
10CC0000C01
11000000P01
100C00000C1
10C00100001
10001C00C01
1100CE00001
10100000001
11111111111