1111111111111
100100000C0C1
11C0000000001
10C00C0100001
101000C00CE01
10000C0000001
100000010C001
100C0P0000001
1111111111111