1111111111
1000000001
1000000011
1C0C000001
1000CC0001
101C000111
10000000C1
10000C0E01
100P0C0001
100C000C01
1111111111