1111111111
100C000CC1
1000100101
100C000001
10C0000011
1001110001
100C000001
1C10000001
1E11001001
1100000101
100C000101
1010P00001
1111111111